08 05 03
XXXXXXXX
XG...JMX
XG...J.X
XG...J.X
XXXXXXXX