10 05 03
XXXXXXXXXX
XG.....JMX
XG.....J.X
XG.....J.X
XXXXXXXXXX