06 05 03
XXXXXX
XGGGGX
XJJJ.X
X..M.X
XXXXXX
