06 05 01
XXXXXX
X.G..X
X.J..X
X..M.X
XXXXXX