10 07 03
XXXXXXXXXX
X..G..X..X
X..GJ...MX
X..GJ....X
X..XJ....X
X..X.....X
XXXXXXXXXX